{
    "Maps": [
        {
            "name": "TestMap1",
            "map": [
                [1,1,1,1,1,1,1,1,1,1],
                [1,0,0,0,0,0,0,0,0,1],
                [1,0,0,1,1,1,1,1,1,1],
                [1,0,0,0,0,0,0,0,0,1],
                [1,4,4,4,4,4,4,0,4,1],
                [1,4,0,0,0,0,0,0,4,1],
                [1,4,4,4,4,4,4,4,4,1],
                [1,1,1,1,1,1,1,1,1,1]
            ],
            "teams": [
                [
                    [4, 1]
                ],
                [
                    [1, 1]
                ]
            ]
        },
        {
            "name": "TestMap2",
            "map": [
                [2,2,2,2,2,1,1,1,1,1,1,1,1,1],
                [2,2,2,1,1,1,1,1,1,1,1,1,1,1],
                [2,1,0,0,1,1,1,1,0,0,0,0,0,1],
                [2,1,0,1,1,1,1,1,0,0,0,2,0,1],
                [2,1,0,0,0,0,1,1,0,0,0,2,0,1],
                [2,1,0,0,0,0,0,0,0,0,0,0,0,1],
                [1,1,1,0,0,0,0,0,0,0,0,0,0,1],
                [4,4,4,4,4,5,0,0,0,0,0,0,0,1],
                [4,0,0,0,0,0,0,0,0,0,0,0,0,1],
                [4,0,0,0,4,5,0,0,0,0,0,0,0,1],
                [4,3,0,0,4,1,1,1,0,0,0,0,0,1],
                [4,4,4,4,4,1,1,1,1,1,1,1,1,1]
            ],
            "teams": [
                [
                    [3, 4],
                    [3, 5]
                ],
                [
                    [5, 5]
                ]
            ]
        }
    ]
}